##########+##
#-#*---------
##-#------*--
##-##---#--#-
#--#-##-####-
##-#-##-##--#
#############